11111111111111111111
10010000N00000000NC1
10000000000011111001
1P00111111111E000NN1
11111111111111111111