1111111111111
1001000000001
1000011111001
1P0011EE00001
1111111111111