11111111111111111111
100100000000000000C1
10000000000011111001
1P00111111111E0000C1
11111111111111111111